# name: map1
# type: matrix
# rows: 10
# columns: 10
 1 1 0 0 0 0 0 0 0 0
 1 1 0 0 0 0 0 0 0 0
 0 0 0 0 0 0 0 0 0 0
 0 0 0 0 0 0 0 0 0 0
 0 0 0 0 0 0 1 1 1 0
 0 0 0 0 0 0 1 1 1 0
 0 0 0 0 0 0 0 0 0 0
 0 0 0 0 0 0 0 0 0 0
 0 0 0 0 0 0 0 0 0 0
 2 0 0 0 0 0 0 0 0 0
