# name: map2
# type: matrix
# rows: 12
# columns: 14
 0 0 0 0 0 0 0 0 0 0 0 0 0 0
 0 0 0 0 0 0 0 0 0 0 0 0 0 0
 0 0 0 0 0 0 0 0 0 0 0 0 0 0
 0 0 0 0 0 0 0 0 0 0 0 0 0 0
 0 0 0 0 0 1 1 1 1 0 0 0 0 0
 0 0 0 0 0 1 1 1 1 0 0 0 0 0
 0 0 0 0 0 1 1 1 1 0 0 0 0 0
 0 0 0 0 0 1 1 1 1 0 1 1 0 0
 0 0 0 0 0 1 1 1 1 0 1 1 0 0
 0 0 0 0 0 1 1 1 1 0 1 1 0 0
 0 0 0 0 0 1 1 1 1 0 1 1 0 0
 0 0 0 0 0 1 1 1 1 0 0 0 0 2
