# name: map3
# type: matrix
# rows: 14
# columns: 5
 0 0 0 0 0
 0 0 0 0 0
 0 0 1 1 1
 0 0 1 1 1
 0 0 1 1 1
 0 0 1 0 0
 0 0 1 0 0
 0 0 0 0 0
 0 0 0 0 0
 0 0 0 0 0
 0 0 0 0 0
 0 0 0 0 0
 0 0 0 0 0
 0 2 0 0 0
